rude = kasar
polite = sopan
offensive = menyinggung
almost = hampir
contain = berisi
decide = memutuskan
exactly = tepat
at ease = santaidarah
stranger = orang asing
emphasis = penekanan
emphasize = menekan
silly = konyol
curse = mengutuk
dive = menyelam
occasion = kesempatan
appropriate = sesuai
patient = sabar
harpoon = seruit
cracked = retak
stolen = dicuri
foggeist = paling berkabut
perhaps = mungkin
devote = mendedikasikan
shrine = kuil
corner = sudut
Obviously = Jelas sekali
Precisely = Dengan tepat
Wisdom = Kebijaksanaan
Hanged = Digantung
overlay = hamparan
Down south = di selatan
weepy = menangis
pity = Kasihan
Unfleaset = tidak berbulu
Slaughtered = Disembelih
slaughter = pembantaian
Prophecy = ramalan
Bleeding = berdarah
